1212121212
0121212120
0012121200
0001212000
0000120000