1212121212
1212121212
1201201201
1020102010
1002001002
1101102202
