0011212100
0000011000
0011212100
0011212100
0011212100
1122112221